.........................................................................................................................................................................*
.........................................................................................................................................................................*
.........................................................................................................................................................................*
.........................................................................................................................................................................*
.........................................................................................................................................................................*
.........................................................................................................................................................................*
.........................................................................................................................................................................*
.........................................................................................................................................................................*
.........................................................................................................................................................................*
.........................................................................................................................................................................*
.........................................................................................................................................................................*
.........................................................................................................................................................................*
.........................................................................................................................................................................*
.........................................................................................................................................................................*
.........................................................................................................................................................................*
.........................................................................................................................................................................*
.........................................................................................................................................................................*
.........................................................................................................................................................................*
.........................................................................................................................................................................*
.........................................................................................................................................................................*
.........................................................................................................................................................................*
.........................................................................................................................................................................*
.........................................................................................................................................................................*
.........................................................................................................................................................................*
.........................................................................................................................................................................*
.........................................................................................................................................................................*
.........................................................................................................................................................................*
.........................................................................................................................................................................*
.........................................................................................................................................................................*
.........................................................................................................................................................................*
..@.........?...?...?..??...??.......?...?...?.??..???........??........?.....?...??......??........?....?..........?.........?......?.......?........?.......?..........*
#########################################################################################################################################################################*
#########################################################################################################################################################################*
#########################################################################################################################################################################*
#########################################################################################################################################################################*
#########################################################################################################################################################################*
#########################################################################################################################################################################*